NO ./texture/NO.xpm
SO ./texture/NO.xpm
WE ./texture/NO.xpm
EA ./texture/NO.xpm

F 220,100,0
C 225,30,0

11111111111111111111111111111111111111111111111111111
10000000010110010110000000000000000000000111111111111
10000000010110010110000000000000000010000000111111111
111110000000000000000000000000000000010000N1111111111
11111000000011111111111000000000000000000000000011111
11111000000011111111111000000000000000000000000011111
11111000000000000000000001111111111100000000000011111
11111000111100000000000000111111111100000000000011111
11111000111100000000000000111100000000000000000011111
11111000111100000000000000111100000000000000000011111
11111000000000001111111111110000000000000000000011111
11111000000000001111111111110000000111111000111111111
11111000000000001111111111110000000111111000111111111
11111000000000000000001111110000000001110000000011111
11111111111111000000001111110011110001110000000011111
11111111111111000000001111110011110001110000000011111
11111111111111000000001111110011110001111111110011111
11111000000000000000001111110011110001111111110011111
11111000000011111111111111110011110000000000000011111
11111000000011111111111111110011110001111111111111111
11111000000011111111111111110011110001111111111111111
11111000110000000000000000000011110000000000000011111
11111000110000000000000000000011110000000000000011111
11111000110000000000000000000011110000000000000011111
11111000111100001111111111111111110000000000000011111
11111000111100001111111111111111110000000000000011111
11111000111100001100000000000011110000000000000011111
11111000000000001100000000000011110000000000000011111
11111000000000000000000000000011110000000000000011111
11111111111111111111111111111111111111111111111111111