NO ./texture/bricks.xpm
SO ./texture/blue.xpm
WE ./texture/eagle.xpm
EA ./texture/redBrick.xpm

F 154,115,82
C 0,191,255

        1111111111111111111111111
        1000000000110000000000001
        1011000001110000000000001
        1001000000000000000000001
111111111011000001110000000000001
100000000011000000000000000000011
100000000011000000000000000000011
100000000011000000000000000000011
100000000011000000000000000000011
100000000010000000000000000000011
100000000011000000000N00000000011
100000000001000000000000000000011
100000000011000000000000000000011
100000000000000000000000000000011
100000000011000000000000000000011
100000000011000000000000000000011
111111111011000001110000000000001
111111111111111111111111111111111